NO textures/texture1.xpm
SO textures/texture1.xpm
WE textures/texture2.xpm
EA textures/texture2.xpm

F 220,100,0
C 225,30,0

11111111111111111111111111111111  
 1000001000000000110000000000001
 100000101100000111000000000111111111
 100000100100000000000000000000100001
11011111111110110000011100000000000011
10000000001100000111011111111111111111
11010111111111011100000010001
11010111111111011101010010001
110000001101010111000000Q0001
10000N0000000001100000010001
100000000000001101010010001
100000011101010111110111100111
1000111 1110101 101111010001
11111111 1111111 111111111111