NO textures/wolfenstein/grey_stone.xpm
SO textures/wolfenstein/purple_stone.xpm
WE textures/wolfenstein/red_brick.xpm
EA textures/wolfenstein/wood.xpm

F 50,50,50
C 100,100,255

111111111111111111111111111111111   
        1000000000110000000000001
        101100000111000000000111111111
        100100000000000000000000100001
11111111111110110000011100000000000011
10000000001100000111011111111111111111
11110111111111011100000010001
11110111111111011101010010001
11000000110101011100000010001
10000000000000001100000010001
10E0000000000001101010010001
110000011101010111110111100111
11110111 1110101 101111010001
11111111 1111111 111111111111