NO textures/wolfenstein/grey_stone.xpm
SO textures/wolfenstein/purple_stone.xpm
WE textures/wolfenstein/red_brick.xpm
EA textures/wolfenstein/wood.xpm

F 80,80,80
C 120,120,200

1111111111111
1000000000001
1000000000001
1000000N00001
1000000000001
1000000000001
1111111111111
